WWWWTWWWWW        WWWWTWWWWWWWWWWWWWWWWW
W--------W        W--------------------W
T---[----W        W--------------------]
W--------W        W--------------------W
W--------WWWWWWWWWW--------------------W
W------------D--------------L----------W
W--------WWTWWWWTWW--------------------W
W--------W        W--------------------W
T-smlpob-T        W--------------------W
W--------W        W--------------------W
WWWWWWWWWW        WWWWTWWWWWWWWWWWWWWWWW
