              WWTWWWWTWWWWTWWW             
          WWWW--s-----[--s--oWWWW         
        WW----------e--l--p-b----WWW       
      TW--p--------WTWWWTWWWTW------T      
     W--WWTWW----WW-h---p--1-WT------WW    
    W-----e--WDWWT-------------WW-----eW   
   T---W--------------------------------W  
  W--------WW--------L-b--------L-------W  
  W---------1-------------oWTWW----------T 
 W------WTWWWWTW---------WW-p-WWDWTW------W
W---WWWW--m-W-----------T2--------W-----W--W
T----W1-----WWTWDW------W---W-----W--W-----W
W----T--Lp-W---s--W----W----eW-----W-------T
W---WW---p--------W---W1------------WW-----W
W---Wl-h-----2WWDWW----WTWWW---m---p-W-----W
T----WWWWTWWWTW------------WTWWWDWWWW-----W
 W--------------W--------WTWW-W---WW------W
  T------L--WT------L---------------W----W 
  WT------WWWW--W-------WTWW--WW--------W  
   WppW--WW-1-WWWT-----W--------W------WW  
    W-eWTop--T------WTWW-1-------T----W    
     WTW-WW-b-1-W----2-W---------W-2-W     
       WWWWWTWWWW----L-WTWWWTWWWT--WW      
         WW---po-WDWWWW------1-WWWW        
           WWWb---s-L---L---WWW           
              WWWWWWWW]WWWWWW              