WWTWTWTWW
W-------W
T---[---TWWTWWW
W---L---D-----]
W-------W-----W
T-------TWWWTDWWW           WWWTWWW
W------sW---1---W           W-----W
T------mT-------T           W-----W
Wo--L--lW---L---WWTWTWTWTWTWW-----W
Wb-----pW-------------D--------L--W
T---------------TWTWTWTWTWTWW-----W
W---------------W           W-----W
WWWTWTWTWTWTWTWWW           W--2--W
                            W-----W
                            WWWTWWW