   WWWWWWWWW
   Wmp-p-psW
   W---[---W
   Wp-----pW
   We-----eW
   Wo-L-L-sW
   WWWe-hWWW
     WL-LW  
     W--hW
     WL-LW
     W--hW
     WL-LW
     Wh--W
     WL-LW                                                                                         
WWWTWWWDWTWWWWWTWWWWWTWWWWWTWWWWWTWWWWWTWWWWWTWWWWWTWWWWWTWWWWWTWWWWWTWWWWWTWWWWWTWWWWWTWWWWWTWWWWWTWWWWWTWWWWWTWWWWWTWWWWWW
Wl-lo1W-----L-----L--b--L-----L--e--L-----L-----L--s--L-----L-----L-----LW----L-----L-----L----2L-----L-1---L-----LW---Lh--W
T--L--T--------W-----W-----W----hWo---mW-----W-----W----WTWWTWWTWWTW------W----------------------------------------W-e-----W
Wp---mW---------------W-2--------WW-1-WW--------h------mWe-o-b-b--W--------W-------W1-------------WWTWW------------W-------W
W---pW--------------------------------------------------T-2--------T--------W-------------------T------1T-------------T----W
T-p-TWTWWTWW------L-----L-----L-----L-----L-----L--o--L-Wp--h-----1-----2---D-----------------------G----------------W-W---]
W--W------W---------------------------------------------W----------T--------W-------------------T------1T-----------T---T--W
WDW----2--T-----------W-1--------WW-1-WW--------p-------Tp--------W----------W-----W1-------------WWTWW------------W--l----W
W--------------W-----W-----W-----Wp---pWh----W-----W----WTWWT-1----W----------W------------------------------------W--1----W
W-----------L-----L--b--L-----L-----L-----L--o--L--s--L-D---L-----L-----L-----LW----L-----L----2L-----L-1---L-----LW---L---W
WWWWWWWWWTWWWWWTWWWWWTWWWWWTWWWWWTWWWWWTWWWWWTWWWWWTWWWWWTWWWWWTWWWWWTWWWWWTWWWWWTWWWWWTWWWWWTWWWWWTWWWWWTWWWWWTWWWWWTWWWWWW
                                                                                                                             