WWTWTWTWWWWTWWTWWWWW
W--spob-W-------m--W
T-[---L-W--1----p--T
W---W---W----------W
WWTWWWDWW---T------T
Wm--D---------W--p-W
Tpo-W---------W--p-W
WWTWWWTWWTWDWTWTWTWW
T---W--2-W---W-----W
W-L---p--T---T--1--W
T---TWWTWW---W--L--W
W---Wl-------D-----W
W---W--o-----WWTWTWW
T-1-T--------------T
W---W-------L---1--W
T--pT---W-sb-------T
WWDWW---WWTWT---o--W
Wp-------pbpW------W
Ws----b------------]
WWTWWTWWTWWTWWTWWTWW