WWTWTTWTWW      WWWTWWWWTWW
W--------W      T---------W
T-[------WTWTWTWW----L----T
W----------D--------------W
T---L----WTWTWTWWWWTWW-WWTW
W----------D--------------W
T-smlpob-WTWTWTW----L--p--W
W--------W     W-------p--W
WWTWTTWTWW     T-------p--T
               W----L-----W
               T----------T
               WWWWW]WWWWWW
