          WWWTWWW
          W-----W
WWWWWWWWWWT-----TWWWWWWWWWWWW
]------------G--------------]
WWWWWWWWWWT-----TWWWWWWWWWWWW
          W-----W
          WWWTWWW